{
  "gridSize": 50,
  "gravity": 18,
  "uiFont": "assets/opensans.ttf",
  "player": {
    "size": { "w": 1, "d": 1, "h": 1.5 },
    "jumpHeight": 1.5,
    "speed": 4.5,
    "turnSpeed": 2.6,
    "sprite": {
      "front": "assets/player_front.gif",
      "back": "assets/player_back.gif",
      "width": 1,
      "height": 1.5,
      "fps": 12,
      "alphaCutoff": 0.4,
      "idleFrame": 0
    },
    "spawn": { "x": 2.5, "y": 1, "z": 4.5 }
  },
  "npcs": [
    {
      "id": "guide",
      "spawn": { "x": 4.5, "y": 1, "z": 1.5 },
      "yaw": 3.14
    }
  ],
  "camera": {
    "distance": 4.5,
    "height": 2.4,
    "lookHeight": 0.8,
    "smooth": 0.18
  },
  "blocks": [
    { "x": 0, "y": 0, "z": 0 },
    { "x": 1, "y": 0, "z": 0 },
    { "x": 2, "y": 0, "z": 0 },
    { "x": 3, "y": 0, "z": 0 },
    { "x": 4, "y": 0, "z": 0 },
    { "x": 5, "y": 0, "z": 0 },
    { "x": 0, "y": 0, "z": 1 },
    { "x": 1, "y": 0, "z": 1 },
    { "x": 2, "y": 0, "z": 1 },
    { "x": 3, "y": 0, "z": 1 },
    { "x": 4, "y": 0, "z": 1 },
    { "x": 5, "y": 0, "z": 1 },
    { "x": 0, "y": 0, "z": 2 },
    { "x": 1, "y": 0, "z": 2 },
    { "x": 2, "y": 0, "z": 2 },
    { "x": 3, "y": 0, "z": 2 },
    { "x": 4, "y": 0, "z": 2 },
    { "x": 5, "y": 0, "z": 2 },
    { "x": 0, "y": 0, "z": 3 },
    { "x": 1, "y": 0, "z": 3 },
    { "x": 2, "y": 0, "z": 3 },
    { "x": 3, "y": 0, "z": 3 },
    { "x": 4, "y": 0, "z": 3 },
    { "x": 5, "y": 0, "z": 3 },
    { "x": 0, "y": 0, "z": 4 },
    { "x": 1, "y": 0, "z": 4 },
    { "x": 2, "y": 0, "z": 4 },
    { "x": 3, "y": 0, "z": 4 },
    { "x": 4, "y": 0, "z": 4 },
    { "x": 5, "y": 0, "z": 4 },
    { "x": 0, "y": 0, "z": 5 },
    { "x": 1, "y": 0, "z": 5 },
    { "x": 2, "y": 0, "z": 5 },
    { "x": 3, "y": 0, "z": 5 },
    { "x": 4, "y": 0, "z": 5 },
    { "x": 5, "y": 0, "z": 5 },
    { "x": 3, "y": 1, "z": 2 },
    { "x": 4, "y": 1, "z": 2 },
    { "x": 4, "y": 1, "z": 3 },
    { "x": 1, "y": 1, "z": 4 }
  ]
}
